date,Open_Interest_All,Prod_Merc_Positions_Long_ALL,Prod_Merc_Positions_Short_ALL,Swap_Positions_Long_All,Swap__Positions_Short_All,Swap__Positions_Spread_All,M_Money_Positions_Long_ALL,M_Money_Positions_Short_ALL,M_Money_Positions_Spread_ALL,Other_Rept_Positions_Long_ALL,Other_Rept_Positions_Short_ALL,Other_Rept_Positions_Spread_ALL,Tot_Rept_Positions_Long_All,Tot_Rept_Positions_Short_All,NonRept_Positions_Long_All,NonRept_Positions_Short_All,Change_in_Open_Interest_All,Change_in_Prod_Merc_Long_All,Change_in_Prod_Merc_Short_All,Change_in_Swap_Long_All,Change_in_Swap_Short_All,Change_in_Swap_Spread_All,Change_in_M_Money_Long_All,Change_in_M_Money_Short_All,Change_in_M_Money_Spread_All,Change_in_Other_Rept_Long_All,Change_in_Other_Rept_Short_All,Change_in_Other_Rept_Spread_All,Change_in_Tot_Rept_Long_All,Change_in_Tot_Rept_Short_All,Change_in_NonRept_Long_All,Change_in_NonRept_Short_All
1/7/2014,4276785,2411676,998142,325136,1793955,254335,307823,61243,388432,44075,233304,499751,4231228,4229162,45557,47623,157186,43957,61095,-5015,60884,-1889,-8199,5389,6888,26458,-91389,83709,145909,124687,11277,32499
1/14/2014,4119599,2367719,937047,330151,1733071,256224,316022,55854,381544,17617,324693,416042,4085319,4104475,34280,15124,216266,113233,-18559,24374,86255,-23072,-52964,17684,129634,-17438,-19496,42281,216048,214727,218,1539
1/21/2014,3903333,2254486,955606,305777,1646816,279296,368986,38170,251910,35055,344189,373761,3869271,3889748,34062,13585,46077,47971,1318,3908,57024,-15399,13501,-24900,8104,-3537,25970,-9492,45056,42625,1021,3452
1/28/2014,3857256,2206515,954288,301869,1589792,294695,355485,63070,243806,38592,318219,383253,3824215,3847123,33041,10133,31304,76003,1427,906,84277,-33193,28866,-5491,-11044,-2422,25962,-26631,32485,35307,-1181,-4003
2/4/2014,3825952,2130512,952861,300963,1505515,327888,326619,68561,254850,41014,292257,409884,3791730,3811816,34222,14136,-234993,-161387,-53165,-36120,-63166,-30353,38997,-6272,-37622,19667,-18165,-30577,-237395,-239320,2402,4327
2/11/2014,4060945,2291899,1006026,337083,1568681,358241,287622,74833,292472,21347,310422,440461,4029125,4051136,31820,9809,71279,29683,-3899,6169,4985,2664,1899,10432,13177,-1267,22443,21728,74053,71530,-2774,-251
2/18/2014,3989666,2262216,1009925,330914,1563696,355577,285723,64401,279295,22614,287979,418733,3955072,3979606,34594,10060,76296,64769,5865,-11849,55243,7690,-17717,-7540,9869,1312,-16174,21891,75965,76844,331,-548
2/25/2014,3913370,2197447,1004060,342763,1508453,347887,303440,71941,269426,21302,304153,396842,3879107,3902762,34263,10608,86748,23794,10911,-18111,17593,11736,17092,-6764,15143,2019,2781,34438,86111,85838,637,910
3/4/2014,3826622,2173653,993149,360874,1490860,336151,286348,78705,254283,19283,301372,362404,3792996,3816924,33626,9698,-192830,-145974,-62364,-5551,-45142,5851,25447,-3564,-42466,-11938,-27190,-20037,-194668,-194912,1838,2082
3/11/2014,4019452,2319627,1055513,366425,1536002,330300,260901,82269,296749,31221,328562,382441,3987664,4011836,31788,7616,-1907,-2122,-92274,11991,53086,-6472,-7183,9616,14387,-1991,32010,-7640,970,2713,-2877,-4620
3/18/2014,4021359,2321749,1147787,354434,1482916,336772,268084,72653,282362,33212,296552,390081,3986694,4009123,34665,12236,43868,38112,-632,-10141,29885,3228,-2343,-743,-5559,2564,-172,17673,43534,43680,334,188
3/25/2014,3977491,2283637,1148419,364575,1453031,333544,270427,73396,287921,30648,296724,372408,3943160,3965443,34331,12048,26407,39224,12997,-7179,40213,4151,9134,4277,5449,1531,-19600,-20399,31911,27088,-5504,-681
4/1/2014,3951084,2244413,1135422,371754,1412818,329393,261293,69119,282472,29117,316324,392807,3911249,3938355,39835,12729,111899,57139,24516,12168,891,1143,-14795,-1017,39971,813,27967,20233,116672,113704,-4773,-1805
4/8/2014,3839185,2187274,1110906,359586,1411927,328250,276088,70136,242501,28304,288357,372574,3794577,3824651,44608,14534,-175832,-83067,-41676,-172,-79433,2489,10951,-2136,-16942,-8732,47246,-87236,-182709,-177688,6877,1856
4/15/2014,4015017,2270341,1152582,359758,1491360,325761,265137,72272,259443,37036,241111,459810,3977286,4002339,37731,12678,-20086,85164,1277,16460,-663,-11478,-37268,-827,9519,-39409,27053,-42863,-19875,-17982,-211,-2104
4/22/2014,4035103,2185177,1151305,343298,1492023,337239,302405,73099,249924,76445,214058,502673,3997161,4020321,37942,14782,55783,34305,31297,-3922,44250,2045,24279,15413,-31436,16534,-16750,10571,52376,55390,3407,393
4/29/2014,3979320,2150872,1120008,347220,1447773,335194,278126,57686,281360,59911,230808,492102,3944785,3964931,34535,14389,32186,7477,11349,7068,-9145,709,3015,8141,-232,1158,8798,12796,31991,32416,195,-230
5/6/2014,3947134,2143395,1108659,340152,1456918,334485,275111,49545,281592,58753,222010,479306,3912794,3932515,34340,14619,-246541,-192249,-44006,22148,-45696,-20662,-858,5854,-44171,1568,-88345,-11757,-245981,-248783,-560,2242
5/13/2014,4193675,2335644,1152665,318004,1502614,355147,275969,43691,325763,57185,310355,491063,4158775,4181298,34900,12377,-6271,41735,-27288,3113,-4082,6884,-44085,-27170,11272,3532,61134,-27470,-5019,-6720,-1252,449
5/20/2014,4199946,2293909,1179953,314891,1506696,348263,320054,70861,314491,53653,249221,518533,4163794,4188018,36152,11928,81818,100538,40648,10170,21456,-7398,-5489,-10433,-22770,-15554,42613,19337,78834,83453,2984,-1635
5/27/2014,4118128,2193371,1139305,304721,1485240,355661,325543,81294,337261,69207,206608,499196,4084960,4104565,33168,13563,140352,53017,27751,1345,45755,623,4154,-2221,12827,-6169,-20194,77030,142827,141571,-2475,-1219
6/3/2014,3977776,2140354,1111554,303376,1439485,355038,321389,83515,324434,75376,226802,422166,3942133,3962994,35643,14782,-103352,-98089,-53432,3246,11746,2158,36356,-24352,-35344,20407,30147,-32793,-104059,-101870,707,-1482
6/10/2014,4081128,2238443,1164986,300130,1427739,352880,285033,107867,359778,54969,196655,454959,4046192,4064864,34936,16264,52490,16814,3562,7700,33646,-16244,-20447,-13257,29190,-2507,-23593,39046,53552,52350,-1062,140
6/17/2014,4028638,2221629,1161424,292430,1394093,369124,305480,121124,330588,57476,220248,415913,3992640,4012514,35998,16124,103068,85057,85388,-5100,16693,-3884,12191,-1155,-3581,21741,12750,-691,105733,105520,-2665,-2452
6/24/2014,3925570,2136572,1076036,297530,1377400,373008,293289,122279,334169,35735,207498,416604,3886907,3906994,38663,18576,10253,12093,29093,-7320,5858,-15671,13476,1988,-14546,18696,-2979,6471,13199,10214,-2946,39
7/1/2014,3915317,2124479,1046943,304850,1371542,388679,279813,120291,348715,17039,210477,410133,3873708,3896780,41609,18537,-22567,18839,-16223,-1943,10479,11371,-6839,-15042,7655,-19247,14806,-37208,-27372,-24162,4805,1595
7/8/2014,3937884,2105640,1063166,306793,1361063,377308,286652,135333,341060,36286,195671,447341,3901080,3920942,36804,16942,-161837,-150393,-12419,-11282,-74388,12916,-8650,12778,-16325,24119,-75790,-11098,-160713,-164326,-1124,2489
7/15/2014,4099721,2256033,1075585,318075,1435451,364392,295302,122555,357385,12167,271461,458439,4061793,4085268,37928,14453,-4027,50399,-25637,9018,24477,-17530,-25272,-4682,22715,-21817,21249,-23071,-5558,-2479,1531,-1548
7/22/2014,4103748,2205634,1101222,309057,1410974,381922,320574,127237,334670,33984,250212,481510,4067351,4087747,36397,16001,88727,34979,11360,-2945,34789,12783,-8201,9935,7394,21232,-13446,23960,89202,86775,-475,1952
7/29/2014,4015021,2170655,1089862,312002,1376185,369139,328775,117302,327276,12752,263658,457550,3978149,4000972,36872,14049,86659,37817,74473,39757,-6620,-4166,18027,18593,-32834,-20821,-11115,47360,85140,85691,1519,968
8/5/2014,3928362,2132838,1015389,272245,1382805,373305,310748,98709,360110,33573,274773,410190,3893009,3915281,35353,13081,-157593,-98114,-64401,31533,-101639,-28082,-33624,-28528,1609,-47299,47874,22564,-151413,-150603,-6180,-6990
8/12/2014,4085955,2230952,1079790,240712,1484444,401387,344372,127237,358501,80872,226899,387626,4044422,4065884,41533,20071,80,30552,20190,13529,-47054,17967,11862,10296,-9349,-40190,32438,-28244,-3873,-3756,3953,3836
8/19/2014,4085875,2200400,1059600,227183,1531498,383420,332510,116941,367850,121062,194461,415870,4048295,4069640,37580,16235,133856,90289,47591,-9271,68604,-19261,26171,-179,9009,9199,570,26455,132591,132789,1265,1067
8/26/2014,3952019,2110111,1012009,236454,1462894,402681,306339,117120,358841,111863,193891,389415,3915704,3936851,36315,15168,45726,25361,50743,-27435,5594,30881,19263,-5073,21431,42762,11500,-67957,44306,47119,1420,-1393
9/2/2014,3906293,2084750,961266,263889,1457300,371800,287076,122193,337410,69101,182391,457372,3871398,3889732,34895,16561,-162300,-176161,7347,-19759,-73665,-6540,31039,-47258,-13291,38868,-8627,6116,-139728,-135918,-22572,-26382
9/9/2014,4068593,2260911,953919,283648,1530965,378340,256037,169451,350701,30233,191018,451256,4011126,4025650,57467,42943,61394,36850,51826,-1511,-14690,2895,2609,29412,-1197,13324,-18881,-13956,39014,35409,22380,25985
9/16/2014,4007199,2224061,902093,285159,1545655,375445,253428,140039,351898,16909,209899,465212,3972112,3990241,35087,16958,5769,26150,31327,-3980,-6174,8073,2994,-14706,-5653,-10286,5507,-10189,7109,8185,-1340,-2416
9/23/2014,4001430,2197911,870766,289139,1551829,367372,250434,154745,357551,27195,204392,475401,3965003,3982056,36427,19374,36167,13103,-23840,15110,-9625,-3669,-28559,7596,29821,-26548,-2961,37799,37057,35121,-890,1046
9/30/2014,3965263,2184808,894606,274029,1561454,371041,278993,147149,327730,53743,207353,437602,3927946,3946935,37317,18328,-10359,-13311,-19361,11511,-5244,17800,-3068,5612,-2650,-16029,-1294,-6668,-12415,-11805,2056,1446
10/7/2014,3975622,2198119,913967,262518,1566698,353241,282061,141537,330380,69772,208647,444270,3940361,3958740,35261,16882,-126968,-113757,-25459,15717,-84592,-12611,-410,8575,-8900,8881,11663,-13954,-125034,-125278,-1934,-1690
10/14/2014,4102590,2311876,939426,246801,1651290,365852,282471,132962,339280,60891,196984,458224,4065395,4084018,37195,18572,-9048,30488,-9233,14984,-18916,-2154,-10096,14199,-3766,-14931,37494,-24075,-9550,-6451,502,-2597
10/21/2014,4111638,2281388,948659,231817,1670206,368006,292567,118763,343046,75822,159490,482299,4074945,4090469,36693,21169,5027,-25303,-4783,-4443,-17576,20771,-8405,-3856,-6081,-4829,-20338,38148,9858,6285,-4831,-1258
10/28/2014,4106611,2306691,953442,236260,1687782,347235,300972,122619,349127,80651,179828,444151,4065087,4084184,41524,22427,-38772,53723,-27932,2177,69031,-29103,13076,-12275,-30989,-57866,-23385,13736,-35246,-40917,-3526,2145
11/4/2014,4145383,2252968,981374,234083,1618751,376338,287896,134894,380116,138517,203213,430415,4100333,4125101,45050,20282,-278573,-177900,-88257,2621,-113817,2917,13616,-7137,-71066,2356,57466,-63572,-291028,-283466,12455,4893
11/11/2014,4423956,2430868,1069631,231462,1732568,373421,274280,142031,451182,136161,145747,493987,4391361,4408567,32595,15389,-18045,-9751,-60825,-19622,72294,332,-6955,-7404,12154,29599,-12248,-19373,-13616,-15070,-4429,-2975
11/18/2014,4442001,2440619,1130456,251084,1660274,373089,281235,149435,439028,106562,157995,513360,4404977,4423637,37024,18364,78723,52249,21683,15034,63248,-10855,837,-9271,-26046,9808,5744,32545,73572,77048,5151,1675
11/25/2014,4363278,2388370,1108773,236050,1597026,383944,280398,158706,465074,96754,152251,480815,4331405,4346589,31873,16689,-9109,41432,22097,31635,23826,-11523,-29614,-16692,-27328,-3264,10142,-9494,-8156,-8972,-953,-137
12/2/2014,4372387,2346938,1086676,204415,1573200,395467,310012,175398,492402,100018,142109,490309,4339561,4355561,32826,16826,-168639,-145629,-39187,1706,-93286,7309,15984,-60958,-35072,-43300,22055,31594,-167408,-167545,-1231,-1094
12/9/2014,4541026,2492567,1125863,202709,1666486,388158,294028,236356,527474,143318,120054,458715,4506969,4523106,34057,17920,53769,14924,31281,31916,28936,-3257,-47285,49492,-18817,24848,-82529,48894,51223,54000,2546,-231
12/16/2014,4487257,2477643,1094582,170793,1637550,391415,341313,186864,546291,118470,202583,409821,4455746,4469106,31511,18151,27565,56955,7712,16780,83806,-54229,19329,-15296,-17627,-1597,10571,11518,31129,26455,-3564,1110
12/23/2014,4459692,2420688,1086870,154013,1553744,445644,321984,202160,563918,120067,192012,398303,4424617,4442651,35075,17041,75353,20868,-42683,-802,53459,-17,26582,26934,-5320,19337,25429,14469,75117,72271,236,3082
12/30/2014,4384339,2399820,1129553,154815,1500285,445661,295402,175226,569238,100730,166583,383834,4349500,4370380,34839,13959,72386,-2495,12760,3586,-25875,31462,-10733,-8574,66112,11289,25925,-22116,77105,79694,-4719,-7308
1/6/2015,4354548,2551854,950181,333095,2347527,227716,416244,69446,225528,147625,116851,403269,4305331,4340518,49217,14030,131950,99272,49443,35618,53650,-6360,25329,255,-4184,-39135,21882,19902,130442,134588,1508,-2638
1/13/2015,4222598,2452582,900738,297477,2293877,234076,390915,69191,229712,186760,94969,383367,4174889,4205930,47709,16668,-182844,-126146,-47005,-10361,-35473,-6489,-326,11665,-14792,8339,-39529,-12022,-161797,-143645,-21047,-39199
1/20/2015,4405442,2578728,947743,307838,2329350,240565,391241,57526,244504,178421,134498,395389,4336686,4349575,68756,55867,142615,83739,67950,-11162,43922,4175,18492,17569,-43934,52954,-3562,16084,120348,102204,22267,40411
1/27/2015,4262827,2494989,879793,319000,2285428,236390,372749,39957,288438,125467,138060,379305,4216338,4247371,46489,15456,-29015,4744,24496,154,18100,14462,17926,-8890,-28280,-29318,-41038,-7772,-28084,-28922,-931,-93
2/3/2015,4291842,2490245,855297,318846,2267328,221928,354823,48847,316718,154785,179098,387077,4244422,4276293,47420,15549,60502,59384,19383,6077,94960,7400,28453,1399,2001,1821,-19028,-45227,59909,60888,593,-386
2/10/2015,4231340,2430861,835914,312769,2172368,214528,326370,47448,314717,152964,198126,432304,4184513,4215405,46827,15935,17921,28589,5911,8809,892,8317,-10388,-1367,-9011,-5248,13012,101,21169,17855,-3248,66
2/17/2015,4213419,2402272,830003,303960,2171476,206211,336758,48815,323728,158212,185114,432203,4163344,4197550,50075,15869,-195664,-113436,-53539,41059,-70695,-20712,-61276,8319,-21427,24928,13456,-54035,-204899,-198633,9235,2969
2/24/2015,4409083,2515708,883542,262901,2242171,226923,398034,40496,345155,133284,171658,486238,4368243,4396183,40840,12900,129562,106835,-3086,-18293,76235,-12817,-1577,-227,27193,-24834,-10028,55359,131866,132629,-2304,-3067
3/3/2015,4279521,2408873,886628,281194,2165936,239740,399611,40723,317962,158118,181686,430879,4236377,4263554,43144,15967,113567,85444,21901,11755,5230,-7431,-55094,2412,46010,-1055,10978,30559,110188,109659,3379,3908
3/10/2015,4165954,2323429,864727,269439,2160706,247171,454705,38311,271952,159173,170708,400320,4126189,4153895,39765,12059,115033,26866,1074,11987,73474,11397,1385,4195,18075,14529,-22020,27889,112128,114084,2905,949
3/17/2015,4050921,2296563,863653,257452,2087232,235774,453320,34116,253877,144644,192728,372431,4014061,4039811,36860,11110,-147439,-120034,-19821,17646,-8221,-15334,-41299,-5390,-32826,33512,-69919,5819,-152516,-145692,5077,-1747
3/24/2015,4198360,2416597,883474,239806,2095453,251108,494619,39506,286703,111132,262647,366612,4166577,4185503,31783,12857,83382,61087,-5096,16377,86988,-19701,55548,-8681,-10367,-8220,52016,-10580,84144,84579,-762,-1197
3/31/2015,4114978,2355510,888570,223429,2008465,270809,439071,48187,297070,119352,210631,377192,4082433,4100924,32545,14054,55898,67397,4184,11514,28828,3090,24728,2608,-12907,-29000,39163,-9514,55308,55452,590,446
4/7/2015,4059080,2288113,884386,211915,1979637,267719,414343,45579,309977,148352,171468,386706,4027125,4045472,31955,13608,76458,29860,-32375,-15187,153991,486,63738,-7643,682,10641,-25894,-13649,76571,75598,-113,860
4/14/2015,4311953,2402315,1116793,151229,1526160,414199,306135,183800,503126,89441,140658,405950,4272395,4290686,39558,21267,-197719,-171816,-69296,5839,-107099,526,-2808,-16165,-16020,-19824,1386,381,-203722,-206287,6003,8568
4/21/2015,4509672,2574131,1186089,145390,1633259,413673,308943,199965,519146,109265,139272,405569,4476117,4496973,33555,12699,30070,5446,16418,37243,7293,3461,-34431,-27086,29880,-15205,-4552,4359,30753,29773,-683,297
4/28/2015,4479602,2568685,1169671,108147,1625966,410212,343374,227051,489266,124470,143824,401210,4445364,4467200,34238,12402,39274,82178,6885,45632,63014,-36698,-31982,-6785,33355,-32257,4609,-25003,35225,39377,4049,-103
5/5/2015,4440328,2486507,1162786,62515,1562952,446910,375356,233836,455911,156727,139215,426213,4410139,4427823,30189,12505,43612,69485,59120,6739,119,3113,-6251,-20232,53,-30240,151,3,42902,42327,710,1285
5/12/2015,4396716,2417022,1103666,55776,1562833,443797,381607,254068,455858,186967,139064,426210,4367237,4385496,29479,11220,-254305,-142121,-98489,4423,-140213,8830,-21518,40104,-36546,-34570,22480,-11775,-233277,-215609,-21028,-38696
5/19/2015,4651021,2559143,1202155,51353,1703046,434967,403125,213964,492404,221537,116584,437985,4600514,4601105,50507,49916,152676,94644,12595,-1043,104997,-7440,14701,17033,8596,28110,-18015,-2859,134709,114907,17967,37769
5/26/2015,4498345,2464499,1189560,52396,1598049,442407,388424,196931,483808,193427,134599,440844,4465805,4486198,32540,12147,15401,48663,-5121,-388,48751,7340,-25616,-17075,1605,8050,9454,-29598,10056,15356,5345,45
6/2/2015,4482944,2415836,1194681,52784,1549298,435067,414040,214006,482203,185377,125145,470442,4455749,4470842,27195,12102,205437,92469,47964,-8789,163021,-55063,79943,10351,19284,27926,-33094,51763,207533,204226,-2096,1211
6/9/2015,4277507,2323367,1146717,61573,1386277,490130,334097,203655,462919,157451,158239,418679,4248216,4266616,29291,10891,-187201,-143628,-32960,-7939,50514,-24560,27671,97,-50235,11249,-131862,3128,-184314,-185878,-2887,-1323
6/16/2015,4464708,2466995,1179677,69512,1335763,514690,306426,203558,513154,146202,290101,415551,4432530,4452494,32178,12214,52956,53022,14729,4073,19193,10481,23169,9572,-8246,-9687,30691,-21988,50824,54432,2132,-1476
6/23/2015,4411752,2413973,1164948,65439,1316570,504209,283257,193986,521400,155889,259410,437539,4381706,4398062,30046,13690,68883,95266,3919,3342,-10756,13200,-19543,15623,-13335,-10907,57938,694,68717,67283,166,1600
6/30/2015,4342869,2318707,1161029,62097,1327326,491009,302800,178363,534735,166796,201472,436845,4312989,4330779,29880,12090,91059,101002,12539,1674,8138,5769,-13191,25159,10730,-4429,34197,-8473,93082,88059,-2023,3000
7/7/2015,4251810,2217705,1148490,60423,1319188,485240,315991,153204,524005,171225,167275,445318,4219907,4242720,31903,9090,785,101656,33648,2230,-25956,865,-33906,9492,35206,-15123,41751,-41642,49286,53364,-48501,-52579
7/14/2015,4251025,2116049,1114842,58193,1345144,484375,349897,143712,488799,186348,125524,486960,4170621,4189356,80404,61669,-75851,-127522,49863,3478,-67500,-8346,-14277,110,5761,38056,-78612,-29013,-131863,-127737,56012,51886
7/21/2015,4326876,2243571,1064979,54715,1412644,492721,364174,143602,483038,148292,204136,515973,4302484,4317093,24392,9783,43994,85923,5878,-2301,35761,-34596,-36377,-2268,21914,-4633,3788,15671,45601,46148,-1607,-2154
7/28/2015,4282882,2157648,1059101,57016,1376883,527317,400551,145870,461124,152925,200348,500302,4256883,4270945,25999,11937,40481,66326,-16318,-2080,26806,-999,10444,-6585,23120,-27093,40270,-26944,42774,39350,-2293,1131
8/4/2015,4242401,2091322,1075419,59096,1350077,528316,390107,152455,438004,180018,160078,527246,4214109,4231595,28292,10806,90508,76391,-12746,6952,21796,3143,-30155,22216,27579,4078,25819,3044,91032,90851,-524,-343
8/11/2015,4151893,2014931,1088165,52144,1328281,525173,420262,130239,410425,175940,134259,524202,4123077,4140744,28816,11149,-189615,-141519,-58843,4488,-87184,-18888,-13584,22339,-21398,27029,5288,-29459,-193331,-188145,3716,-1470
8/18/2015,4341508,2156450,1147008,47656,1415465,544061,433846,107900,431823,148911,128971,553661,4316408,4328889,25100,12619,71799,46627,36283,-8136,-2382,3735,-7025,15729,1585,1568,-18131,34685,73039,71504,-1240,295
8/25/2015,4269709,2109823,1110725,55792,1417847,540326,440871,92171,430238,147343,147102,518976,4243369,4257385,26340,12324,-25909,9702,35014,-6737,-4992,-32735,13102,11676,-22513,4061,-21754,9450,-25670,-25854,-239,-55
9/1/2015,4295618,2100121,1075711,62529,1422839,573061,427769,80495,452751,143282,168856,509526,4269039,4283239,26579,12379,48502,48995,15269,16575,24298,-14349,-67883,29179,-2588,13426,-57404,54489,48665,48894,-163,-392
9/8/2015,4247116,2051126,1060442,45954,1398541,587410,495652,51316,455339,129856,226260,455037,4220374,4234345,26742,12771,-294799,-101661,-31209,11784,-95363,-47880,-68683,-20690,-35595,-1573,-12792,-46310,-289918,-289839,-4881,-4960
9/15/2015,4541915,2152787,1091651,34170,1493904,635290,564335,72006,490934,131429,239052,501347,4510292,4524184,31623,17731,10052,39093,33963,-6548,-29033,17075,8954,-1291,-20582,1878,40898,-34219,5651,6811,4401,3241
9/22/2015,4531863,2113694,1057688,40718,1522937,618215,555381,73297,511516,129551,198154,535566,4504641,4517373,27222,14490,-7735,10723,845,3551,-59924,8586,-44366,21837,9345,6412,11665,304,-5445,-7342,-2290,-393
9/29/2015,4539598,2102971,1056843,37167,1582861,609629,599747,51460,502171,123139,186489,535262,4510086,4524715,29512,14883,19687,21328,-11251,-9601,-20147,14643,-30118,6084,16372,-4500,-4387,15613,23737,16927,-4050,2760
10/6/2015,4519911,2081643,1068094,46768,1603008,594986,629865,45376,485799,127639,190876,519649,4486349,4507788,33562,12123,-19929,34681,7083,-30,-19363,7485,-11711,-2217,-369,8246,45926,-11307,26995,27238,-46924,-47167
10/13/2015,4539840,2046962,1061011,46798,1622371,587501,641576,47593,486168,119393,144950,530956,4459354,4480550,80486,59290,-138752,-92642,-29590,4947,-139348,10818,-133666,8184,-22689,105145,51128,-31443,-159530,-152940,20778,14188
10/20/2015,4678592,2139604,1090601,41851,1761719,576683,775242,39409,508857,14248,93822,562399,4618884,4633490,59708,45102,21976,13642,-14320,-3755,-20564,2936,20085,2858,-16897,-38190,25377,18996,-3183,-1614,25159,23590
10/27/2015,4656616,2125962,1104921,45606,1782283,573747,755157,36551,525754,52438,68445,543403,4622067,4635104,34549,21512,47797,36336,74149,5955,2607,-14168,12305,-18589,-31591,1746,-6663,36220,46803,41965,994,5832
11/3/2015,4608819,2089626,1030772,39651,1779676,587915,742852,55140,557345,50692,75108,507183,4575264,4593139,33555,15680,-2619,25822,17621,-222,-16525,5471,-83715,-5033,30801,15899,-38161,1068,-4876,-4758,2257,2139
11/10/2015,4611438,2063804,1013151,39873,1796201,582444,826567,60173,526544,34793,113269,506115,4580140,4597897,31298,13541,-169279,-123857,-11360,1569,-134019,-8785,-26047,14884,-19326,-10608,-26246,16730,-170324,-168122,1045,-1157
11/17/2015,4780717,2187661,1024511,38304,1930220,591229,852614,45289,545870,45401,139515,489385,4750464,4766019,30253,14698,-64256,-7870,-301,-10,-20668,6947,-27666,22963,-17560,-3554,-41558,-13996,-63709,-64173,-547,-83
11/24/2015,4844973,2195531,1024812,38314,1950888,584282,880280,22326,563430,48955,181073,503381,4814173,4830192,30800,14781,-28911,-14272,5401,-2829,-47474,8094,-18890,-8401,1729,-3396,9551,4776,-24788,-26324,-4123,-2587
12/1/2015,4873884,2209803,1019411,41143,1998362,576188,899170,30727,561701,52351,171522,498605,4838961,4856516,34923,17368,-73552,33047,-10265,-292,-84209,26809,-36680,20892,-37036,-27855,44890,-35040,-77047,-73959,3495,407
12/8/2015,4947436,2176756,1029676,41435,2082571,549379,935850,9835,598737,80206,126632,533645,4916008,4930475,31428,16961,36908,58814,55609,-1902,-13926,4708,-21414,-968,5503,6237,1973,-15308,36638,37591,270,-683
12/15/2015,4910528,2117942,974067,43337,2096497,544671,957264,10803,593234,73969,124659,548953,4879370,4892884,31158,17644,-125885,-50771,1365,-1286,-84343,-19909,-55857,2704,-14316,30775,3627,-14137,-125501,-125009,-384,-876
12/22/2015,5036413,2168713,972702,44623,2180840,564580,1013121,8099,607550,43194,121032,563090,5004871,5017893,31542,18520,51629,9907,11428,215,11820,1470,41424,-2963,-22942,-14064,15924,35316,51326,50053,303,1576
12/29/2015,4984784,2158806,961274,44408,2169020,563110,971697,11062,630492,57258,105108,527774,4953545,4967840,31239,16944,28809,22110,5520,1381,13830,8747,7344,-5732,8962,11498,23729,-27147,32895,27909,-4086,900
1/12/2016,4955975,2136696,955754,43027,2155190,554363,964353,16794,621530,45760,81379,554921,4920650,4939931,35325,16044,-17545,19323,-18680,-2823,22034,-9721,-53031,749,4668,-14513,-55154,39381,-16716,-16723,-829,-822
1/19/2016,4973520,2117373,974434,45850,2133156,564084,1017384,16045,616862,60273,136533,515540,4937366,4956654,36154,16866,-268655,-86610,-26639,-26070,-66350,-1701,13814,-2657,-138308,10229,7834,-39491,-268137,-267312,-518,-1343
1/26/2016,5242175,2203983,1001073,71920,2199506,565785,1003570,18702,755170,50044,128699,555031,5205503,5223966,36672,18209,-146871,-51364,6128,-12184,-15189,-9680,65652,-1872,-123202,-12944,474,-3642,-147364,-146983,493,112
2/2/2016,5389046,2255347,994945,84104,2214695,575465,937918,20574,878372,62988,128225,558673,5352867,5370949,36179,18097,-45957,5737,-6347,-13109,-69473,29379,8487,-303,-21251,-58052,15534,3871,-44938,-48590,-1019,2633
2/9/2016,5435003,2249610,1001292,97213,2284168,546086,929431,20877,899623,121040,112691,554802,5397805,5419539,37198,15464,-7192,7571,-37296,-4755,14054,-1712,25787,1173,2448,-17512,27941,-12423,-596,-5815,-6596,-1377
2/16/2016,5442195,2242039,1038588,101968,2270114,547798,903644,19704,897175,138552,84750,567225,5398401,5425354,43794,16841,-338381,-98218,-92624,1717,-150683,-3784,-65392,5061,-69964,-62168,15208,-41627,-339436,-338413,1055,32
2/23/2016,5780576,2340257,1131212,100251,2420797,551582,969036,14643,967139,200720,69542,608852,5737837,5763767,42739,16809,-1578,-11885,-15008,-3324,41401,32417,2299,-34,-49910,30483,-9181,-3834,-3754,-4149,2176,2571
3/1/2016,5782154,2352142,1146220,103575,2379396,519165,966737,14677,1017049,170237,78723,612686,5741591,5767916,40563,14238,61786,15290,-21661,8577,106789,-32113,106447,2345,-51985,-32453,13898,45334,59097,62607,2689,-821
3/8/2016,5720368,2336852,1167881,94998,2272607,551278,860290,12332,1069034,202690,64825,567352,5682494,5705309,37874,15059,7926,1170,-15131,767,77534,-57996,27946,3420,9728,31598,-6483,1432,14645,12504,-6719,-4578
3/15/2016,5712442,2335682,1183012,94231,2195073,609274,832344,8912,1059306,171092,71308,565920,5667849,5692805,44593,19637,-280602,-74053,-86958,-14872,-98598,-37165,-49548,-1376,-41289,-50147,-2786,-19063,-286137,-287235,5535,6633
3/22/2016,5993044,2409735,1269970,109103,2293671,646439,881892,10288,1100595,221239,74094,584983,5953986,5980040,39058,13004,73244,61406,-23944,-2283,59587,32372,-48846,-14331,22747,-4180,-13866,10989,72205,73554,1039,-310
3/29/2016,5919800,2348329,1293914,111386,2234084,614067,930738,24619,1077848,225419,87960,573994,5881781,5906486,38019,13314,109106,43884,13229,3260,65082,3193,-12085,510,13245,46469,-851,12426,110392,106834,-1286,2272
4/5/2016,5810694,2304445,1280685,108126,2169002,610874,942823,24109,1064603,178950,88811,561568,5771389,5799652,39305,11042,22711,107102,-10859,-8717,-36220,10816,-4608,-3794,2258,-133384,11523,48283,21750,22007,961,704
4/12/2016,5787983,2197343,1291544,116843,2205222,600058,947431,27903,1062345,312334,77288,513285,5749639,5777645,38344,10338,128433,71042,-7608,-6831,-2628,10847,-6989,6935,143153,-52441,7714,-29674,129107,128739,-674,-306
